111111111111111111111111111111111111111111111111111111111111111111111111111111111111111111111
10010000000CCCCCCCCCCCCCCCCCCCCCCCCCCCCCCCCCCCCCCCCCCCCCCCCCCCCCCCCCCCCCCCCCCCCCCCCCCCCCCCCC1
100001111100000000000000000000000000000000000000000000000000000000000000000000000000000000001
1P0011E00000000000000000000000000000000000000000000000000000000000000000000000000000000000001
111111111111111111111111111111111111111111111111111111111111111111111111111111111111111111111