111111111111111
1P0000000C000P1
100000000000001
1C0000000000001
111111111111111