111111111111111
1000000000C000E
100000000000001
1C0000000000001
111111111111111