111111111111111
1P001C001000001
111011101011101
1C101000100C101
101010111011101
101010000010001
101010111110111
101010000C10001
101010111111101
10001C100000001
101111101111101
100000100010001
111110111010111
1C00000000100E1
111111111111111