111111111111111
1P1E00000000001
101110111111101
1000100000001C1
111010111110111
100010100010001
101111101010101
101C00001010101
101110111010101
101000100010101
101011101111101
100010001000101
111110111010101
1C0000000010001
111111111111111