111111111111111
1P0000101000001
111110101010111
101000100010001
101011101111101
101010001000001
101010111011101
1000100C1000101
101111101110101
100010001000101
111011101011101
10100010101E101
101110111010101
100000000010001
111111111111111