111111111111111
1P00100000000C1
1110101110111C1
10001000101CCC1
10111110101C111
10001000101CCC1
111010111011111
1C10101C1000001
1C10101C1111101
1C001CCCCCCC101
1C1111111111101
1C1CCC1CCCCCC01
1C1C1C1C1111101
1CCC1CCC10000E1
111111111111111